shortdt	randomN
TTCTCGCATG	CGGTCAAGAA
TCCTACCAGT	CGCTCCTAAC
GCGTTGGAGC	ATCCATGACT
GATCTTACGC	AACCTGGTCT
CTGATGGTCA	ACCGAAGACC
CCGAGAATCC	GGTACCGGCA
GCCGCAACGA	AAGCCAGTTA
TGAGTCTGGC	TCTTGCCGAC
TGCGGACCTA	AAGACCGTTG
ACCTCGTTGA	AGGTTAGCAT
ACGGAGGCGG	TTCGCCTCCA
TAGATCTACT	AGAGCCAAGG
AATTAAGACT	AATACCATCC
CCATTGCGTT	AGCTCTCCTC
TTATTCATTC	CTTGATTGCC
ATCTCCGAAC	AGCTTATCCG
TTGACTTCAG	AAGAATCTGA
GGCAGGTATT	CATCTCTGCA
AGAGCTATAA	ACCTGGCCAA
CTAAGAGAAG	TAACTGGTTA
ACTCAATAGG	TTGCTAACGG
CTTGCGCCGC	ACTAGAGAGT
AATCGTAGCG	AATGCCGCTT
GGTACTGCCT	TATAGACGCA
TAGAATTAAC	TCAATCGCAT
GCCATTCTCC	TTCTTAATAA
TGCCGGCAGA	GTCCTAGAGG
TTACCGAGGC	ATATTGATAC
ATCATATTAG	CCGCTGCCAG
TGGTCAGCCA	CCTAGTACGT
ACTATGCAAT	CAATTACCGT
CGACGCGACT	GGCCGTAGTC
GATACGGAAC	CGATTACGGC
TTATCCGGAT	TAATGAACGA
TAGAGTAATA	CCGTTCCTTA
GCAGGTCCGT	GGTACCATAT
TCGGCCTTAC	CCGATTCGCA
AGAACGTCTC	ATGGCTCTGC
CCAGTTCCAA	GTATAATACG
GGCGTTAAGG	ATCAGCAAGT
ACTTAACCTT	GGCGAACTCG
CAACCGCTAA	TTAATTGAAT
GACCTTGATA	TTAGGACCGG
TCTGATACCA	AAGTAAGAGC
GAAGATCGAG	CCTTGGTCCA
AGGAGCGGTA	CATCAGAATG
AAGAAGCTAG	TTATAGCAGA
TCCGGCCTCG	TTACTTGGAA
AGAGAAGGTT	GCTCAGCCGG
CATACTCCGA	ACGTCCGCAG
GCTAACTTGC	TTGACTGACG
AATCCATCTT	TTGCGAGGCA
GGCTGAGCTC	TTCCAACCGC
CCGATTCCTG	TAACCTTCGG
ACCGCCAACC	TCAAGCCGAT
TGGCCTGAAG	CTTGCAACCT
AACCTCATTC	CCATCGCGAA
ATAAGGAGCA	TAGACTTCTT
CGAACGCCGG	GTCCTTAAGA
GGTATGCTTG	AGTAACGGTC
AACCTGCGTA	GTTCGTCAGA
GGCAGACGCC	CGCCTAATGC
TAGCCGTCAT	ACCGGAATTA
CCTGGAAGAG	TAGGCCATAG
GGAGGTTCTA	TAACTCTTAG
CTAGTAGTCT	TATGAGTTAA
ATCATCAACG	TATCATGATC
ACGCGAGATT	GAGCATATGG
GAAGAGGCAT	TAACGATCCA
GGTATCCGCC	CGGCGTAACT
AACTAGGCGC	CGTCGCAGCC
TCGCTAAGCA	GTAGCTCCAT
TATATACTAA	TTGCCTTGGC
ACTTGCTAGA	TGCTAATTCT
AACCATTGGA	GTCCTACTTG
TCGCGGTTGG	GGTAGGTTAG
CGTAGTTACC	GAGCATCATT
TCCAATCATC	CCGCTCCGGC
AATCGATAAT	TTCTTCCGGT
CCATTATCTA	AGGAGAGAAC
TCAACGTAAG	TAACTCAATT
TCTAATAGTA	ACTATAGGTT
AACCGCTGGT	CAAGATGCCG
GATCGCTTCT	AACGTCTAGT
CTAACTAGAT	AGGTATACTC
GCTGGAACTT	TTCATAGGAC
AGGTTAGTTC	GGAGGCCTCC
CATTCGACGG	TTCAATATAA
CATTCAATCA	ACGTCATATA
CGGATTAGAA	TTGACCAGGA
ATCGGCTATC	CGGTTGCGCG
CCTTGATCGT	CAAGGAGGTC
ACGAAGTCAA	TTACGATGAA
TTACCTCGAC	TTGCTGGCAT
GGAGGATAGC	GAGGCATCAA
GGCTCTCTAT	ATTCGACCAA
GGTTGGCGAC	GCCGTATGCT
GTAGATCGTT	CTGAACTGGT
GAGGTCGGTT	CATAACCAGC
ACGCGCTCCT	AAGTTGCCAT
AGCGTCGTAT	AGGCCGCTCG
GACCAATGCG	AGGTAATAGG
AGGTAGAGCT	GTACTAGTAA
TTGCAGCATT	GCGCGGTAGT
GTAGATGCGC	CTGGATTAGT
TCGGTAAGGC	TTGGATCCTT
ACGATAGACT	TTGGAATCTC
GCGGCCAATC	ACCTGGACGC
ACGCGTATCG	CCTGACGTTC
CATGACTCAA	GCGTTCAGCT
ACTCCGCCAA	TTAGCAATAA
ACGTTGAATG	TTGATGCTAT
AGGACTGCGA	CTCTGCGGCA
ACTCGACGCC	AATAATACCA
CCTATCATAA	ACGCCGTTCA
AATCCGGTCA	TTCGCTTACG
CTATTAACCA	TACGGCTACG
GATCCAGCGT	TTCTTATCGA
TGAGACTCTA	TTCCATGGCA
GCGGAGTCGA	AAGTAGTCAG
GAGGCTTATT	TCAGCTCTAA
CGCCAGGCAT	CGAATAGATG
AATACCAGTT	CGGAGATCCG
GCGGTTATTG	ACCGCAGAAT
CATCCAGCCA	TCTCCTATAA
GGCTGCCTTA	CAACCTATAT
TTCTATAGAG	AGTCGAGAAG
TCTAGTCAAG	AAGACGGCCA
ACGGAGAATA	GCCAACGCCA
ATTAACTTAA	TCTACCATTA
CGTATTGAGA	CTTGCGGTCT
TAGCCAGCAA	TTACGTATAC
TCGGCGTCGT	CGATTGGTTA
GCCTGATATA	ACTTAACTAG
GCCTCAGCAT	GCAGACCGGT
ATCTAGGTTC	TGAGTCCAGA
GACGAGGTTG	TGGAGAATTC
CTGGTTGGTT	ACCAGCCTTA
CCGCGCAGGT	GGCGAGCTTA
ACTCTACTGG	TCGAGGAGTA
CCTGAGAGCA	CCTTACTCCT
ACCAGTATAA	TCAGACGAAC
TCCGCCGGTC	CCGTCCAGTA
TGCCTAACTT	GTTCCGCTAA
TTCTCTGAGA	CAGATTCGAT
CCTGCATCAA	TGCATATAAC
TCTGACGAGG	TAGGCAGATA
GATTCCGGAA	TATGCCGAGT
TGGCATAACG	ATAGTCGTAG
TCTCTCATCC	GGATGCAGCA
TTCGCTGCCT	CCGCTATATT
GGATTCTATC	ATCGAGTCGC
TAGAATAGCC	GCGACGCAGA
GCTCGAATCA	AATGGTCGAC
GGCTCGAGAT	TGGAACTAGA
TCCTCTCCGT	GTCCAACTCA
ATAACCGTTC	GTTATGGATC
AGGTCTATGG	TTATAAGAAC
AGCAAGAACC	CAAGCTTCAT
TTGATATGAA	CTGATTAAGA
TGGCAGAAGT	TACTTACTTA
CTTCATTAGA	GGATCTGCAG
AATCGAACTC	ATGCAATATG
GGACGACGCA	TTCCTAGACC
CGTCTATGAA	ACTGCCGATA
CGAATCTCCT	TCCAGAAGGT
GGCTATTCGA	TTCAAGACCA
TCTATCGGTA	TATTACTCAT
CGAAGGCATG	AACTGATCTT
AATTGAGAGA	CCGCGGACCG
GTAGTTGGAT	AATACGCAGG
CCTAAGCGGT	GGTCGCGTCA
CGTAAGGAGT	AATTATCAGC
AAGCATCCTA	CAGCTATCGT
CTGAAGAGAC	ATTGCGCTGA
GGCTTCTGGA	TTGGTAGGCG
AGCGATCCGC	AGCTAAGGTA
ACGCTTCTCT	TCGTAGAGAA
ATATGCCATC	TGATGGCCTT
AAGTACGTTA	TGGAAGTACC
GAATGAGGAG	CTCCAAGGAT
AGGCCGGTAA	AGATATATCG
GCCATCAACT	CATGCTGGTT
ACTGGTAGAT	TCCTCGAGTC
ATGAGTTCTC	GCAAGGAATA
CCATCGGACC	GGCATAGCTT
GGCATCTACC	CTACGGTAGC
TTCTCTACTA	AGTAAGCATA
CCAGGCTCTT	CGCCTCGAAC
ATCCATCAGG	TTAGGATCTA
CTCGGAGCAA	ACTACTGAAG
GGCGGTTGAC	AATCTGGAGT
CCGCGATCTC	TTCGACTTAT
GACGGCAATT	AAGACCTCGA
CGGACCGCGC	TCCAGTCTGA
GAGCCTTCGC	CATAATCGAC
TGAGTCGATG	GCTGGTCCTG
TGCAACCGAG	TCGCCTGCGC
AATACTTAAC	CTTAGCTAAC
GTCCGGAACT	GAGATGGTAG
CCGACCGCTG	AGGAAGTAAG
CTACCGCGTC	AGTAGAAGTC
AATAGAAGAA	TCAGCGGTTA
ACTATAATTG	TATTGGCAAG
GAACTCCTAT	GCAATACTAT
AATTAATAAC	TTGACCGCGG
TGGCGATCAT	TTCAGGAGAT
TTCTGATGAT	TACCGGTCCG
AAGGCCGAAC	GGACGGTTAT
CTAGACGTAA	TTAATCAGAA
GCTATGCAGC	GAACGTAGGC
GAAGCAATCA	GGTATCAATG
CTCCAAGTTA	CAGAAGACTT
AGCGTAAGTT	GTCAATAACT
GGTACGAACC	CGTTACTAAT
CCAAGGAGCG	CGAATATGAC
ACGCGCAAGC	TCCGAAGTCG
GGACTAGATT	TCCTACGATA
CGTTCTCCAA	GTTGAGCGGT
TAAGACTACC	CAACGCAGCT
TACGGTTCCA	ACCAATAATA
ACCTTAACTC	ATCGCATAGC
TACCGATAAC	TCGAAGCCTA
CGACTCGTAG	AGCAGATACG
CAGAATTAGG	TCCTCAACCA
CGTCAAGGCA	AAGTTGGAAC
AATAATTAGA	TGACGCCATG
CCAGGTTGCG	AAGCAACGAC
GAGACCGCCT	GTAGTATAAT
CTCAACGAGA	CAACTATTCG
ATTAGTAATT	GTCCATTACC
CTCCGGATAG	AATGGACTCC
CAGGAACGAA	ACCGTTCATC
GTATAGGTCG	ATAAGACCGC
ACTAAGCCAG	GCATTCGGAG
ATACGGCGTA	CAAGTTCTCA
TGCAGGACTC	TGGTCGGAGT
AGTTGCGCCA	AAGAGGATTA
TAGTAGACGG	GACCATACTG
TAATCAGCCT	GAGGAGACGT
GATTATGGAG	CCGCCTGGAG
CCTACGTAAT	GAGGAATCTT
GCGCATACGT	GCCTTCGAGA
CCTATTAGAC	CGAGACTAGT
GTCGTTCTGA	GAGAGCTGGA
ACGACTGGAC	TTGCAGGTTA
ATCAGCATCA	ACGTCAGAAC
AGGTAACGCG	CCGACCTTGG
CGATCAGAGA	CTAAGTAACG
AGATGATACC	GTCCATGCCG
ACTGCCAGGC	AAGCGCAGAC
AGCGTAACCA	TCATAATTCA
GGACGGTAGG	TTACCGGCTT
TTCTGGAGCG	AATTAATGCG
TAACGCGGAA	ACGGTCGGCC
GGCGCGTCGG	CTACTTCGCT
GGATAAGATC	AAGTATGGCC
CATCCTCGCG	GTTAACTCTC
CTATATTCCA	GGTCGCCAAC
GAGTAGCCGC	GGTATAACCT
TTCTCATAAC	AACTATAGAA
GGCAACGTTG	GTCAGACCTC
CAAGGCTACT	CTTCATTCTC
GTTAACCGGC	TACTGCGGAC
TCTATATCTT	GGTTAACCAA
GCCGCTGAGA	CCGGCCATAA
TCTCCTTGGA	ATGAAGTCTG
AGAATTGGTC	CTCCAGCGAC
TGCAAGGTCC	ACCTTCTCGA
TAATTGATCA	GGTACGCCGA
TAGCGGAGAA	CCAGGCGTTG
CCGCGTCCAA	GAATGGCAGC
CTTAGCAGTT	TTACGAACTT
CTTCGACTCG	CTGAGCATGA
TTAATCCTGA	ATGAGAGATA
TAAGGTCCTT	ACCAAGCCTC
GTTAAGAGGA	CCATATTGGT
AAGCCTATGA	GCTCAGTTCC
GAGTCGTAAC	GCAGTTCGGC
ACTGGACCTC	GTCCGTATTA
CCAGACTTCC	CCGTATATCC
AACGATCATG	AAGAGAGTAA
CAATCATGAG	TGGCGTTGCG
CTCCTCTGCC	TGCCTTATAC
TGGCTAGAAC	GGAATTATCT
TTATCCGCTG	CCTTCATGCG
CTTCTCTCGC	CAATCCTCCA
TAGTTATTCA	TAGGAATGGT
GGCCTCTCCA	CGAGTAGGCA
ATCGGTCCTC	TGAATAGCAA
CTTGCCAGCG	TGATTGAGGT
TTGAATCAAG	TACTGAGTCG
CCTTGAGGAA	ACTCCAGATC
TTATCCAGTA	CTTGCTATCC
CGGACCATCC	TTATCAGAGG
ATGCCGCGCA	TAGTCAATCC
GTTCCGCGCT	CGCATTGGCT
TGGCATCCAG	TCGTTGCGTA
AATAAGATAA	GGTATCGCAA
GCATCAAGAC	ACTAGGAATC
ATCTTGACCA	AGAACGAAGA
CAACTGACGG	AAGTTATAGA
ATTAAGGTCA	TCCGTCGTAC
AGAGAATCAG	CCATCGTCTT
TGAAGGAAGG	AAGAACCGTA
AATCCGTATG	AATGCATGGA
TTCTAAGCTC	AGCATTAGTA
CTGCGATAAG	AGCAAGCGGA
GGATTGCCGG	TCCTATTCTA
CCAATAGAAC	GATCGTCCGT
CCGTCGATTG	GTCGGATATT
AAGCTCCTCC	CATACGGTAT
TAATATAACC	TATCTTAGGT
GGTAACCATC	GTTGGTTGCA
ACCAGACGCT	CTTATGAACC
AGAGTACCAT	CTAGCCTATT
CCAACCTACG	TCGGTCTGGT
CGGAACCGAT	GACCTTCCAT
GATAACCTAT	CTGAACCAAC
GGTAGCCTCG	CTCTGGCAAC
CTACTATGGC	GAGCCTCCAA
ATCAACGGCC	TCGAATCTTG
TCTGGTCGAA	ATATCTGGAC
TCTCTAGGCG	CCTACTAGCA
TCCGGAGAAC	CAAGCATAAC
CGCCGAGGCG	TCATATACCG
TGCAGATCCA	ATGGTCAAGG
TGGTATAGAC	ACCGCAATGG
GGATGGATAA	GAGTTCTAAG
TGGCGGTCCA	GCTCTTAGAA
AGCGGCGAGT	TAATAACTAC
ATCAATGCTA	ACCGACTATT
GGTCGATGAC	TCTCGAACGT
GGAGTTATAC	CTCCATAATT
GGACTCGCCG	TGAATAACGC
CAGTCAGGCT	AGTTCTTGCC
AGAGGCTCGT	ACTCCGTACC
CCTCCTTCAT	CCGGCGCATT
GGCGGAAGCA	CCGGATCTAA
ACTCGCGCAT	GTTCGTTATC
TCAACTCATA	CTGACTCTGA
ACCGAGCCAT	TGGCGCGTAC
TTCAGCCAGC	GGCATGAATC
TCCAATCCAG	AGTTAAGTAA
CCATGCCAAC	GGAGCTAATC
CCAGCATTCT	TGAGAATTAT
GGATCTCTCC	AGGTTCTCGC
ATTAGTTGAC	TGGATAATCA
GGTTGGTACC	GGCGTCTTAG
TGCTTGCCGT	CCGTTGGCCG
AGTAATCCGG	CCTCTTGATG
CCGAACCTTC	AACCTATGCC
GTAACTTACT	ATCAGGCGGT
CCGCTAGGCC	AAGGATATCC
ACTCATCAGT	AGCGATTCAA
CTCTGACCGC	TTCTTATACT
TTCATACCTA	AGGAGTCAAT
GCCTTGCCTC	TGGCCAGTAT
GACGTTCGAA	AACGAGCGGC
TCGGCAGGAC	GGTCCGCATC
ATATCGCCTA	TGGAGCCATA
TTAGAGGTTC	GTTGAGTCCT
TAGGCGTTCC	AGAGCGGCTT
CGCTAATACC	AGGACCAGAC
CGCGCTTGCA	AATCTTGCTC
ATTCAGTTGG	CTTACTCAGG
TATATATGCC	CGAACCAGCA
GTCCTCGGCT	GGCTACGCTA
TCAGAGCATT	GGCGGTATAA
ACTTCAATAC	CATACGACCT
AAGTCATTAA	TTCTCCGGCC
ATCGAGATAC	TGCGTAGCCT
TGGAACGGCT	TCAACGTTCA
AGTATCGTAC	GGTAAGACTG
TTCTAACCAT	GAAGTTGACG
TTCGCCAAGG	ACGCATGACC
TAGTAGCCAA	CCGCTTCAGG
GGTCCTCCGG	CAACCATCAA
CCAACTCTCT	TATGGACTAT
AATGGCGTAA	AACTGAATAA
CGCGGCATAT	CGCGGATTCC
ACTATCCAGG	ACGCGGTCGC
ATTACGCCTC	TGCCAGTAAC
GCCTCCGTCG	ATTATGCTCC
